###################
#.......#.........#
#.###.#.#.#.#####.#
#...............P.#
###################
