#####################
#S........ ........#
#.###.####.####.####
 o...........G....o
#.####.#...#.####.###
#......# #.......G.#
#####################
